fino/a - fine,nice
entonces - so
dar - to give
fresco/a - fresh
corola - corolla
olar - to smell
querer - want
coger - to take, to grab
unas cuantas - a few
sacar - to take out, to extract
atrevir - to dare
modo - mode
bordada/o - embroidery
cosida/o - sewn
la tilma - special kind of canvas, cloak, blanket
la basura - trash
el botton - button
envolvo - to envolve
mantener - to maintaine
tras - after, behind
superar - to overcome, to surpass
exigente - demanding
juré - I swore
cambiar - to change
rescatar - to rescue
obligado/a - obliged, forced
anhelo - longing, desire
curanderismo - traditional healing, folk medicine
saciarlo - to satisfy it
adquirido - acquired
desarrollo - development
dieron - they gave
enfoque - approach, focus
abordado - addressed, tackled
diseño - design
encuesta - survey
bienestar - wellbeing
lluvia - rain 
huelo - i sense
la cetsa - basket
le di - i gave
encontre - i found
muestra - shows
mejor - better
nunca - never
mejor - better
estaba - she was
antes - before
algundia- someday
salir - leave
engermos - ill, sick people
penúltima - second to last
impartir - to impart, to give
enseño - I teach
concienciación - awareness
apoyo - support
breve - brief, short
descuidado/a - careless
casi - almost 
tarda - takes time, delays
voltear - to turn over, to flip
susurro - whisper
ala - wing
torcida/o - twisted, crooked
embargo - embargo, restriction
alféizar - windowsill
asomo - glimpse
soleada/o - sunny
madera - wood
reinaba - reigned, prevailed
rompió - broke
mezcla - mix, mixture
flotando - floating
cierto/a - certain, sure
ambos/as - both
intocable - untouchable
sido - been
cornisa - cornice, ledge
silbido - whistle
luego - then, later
inclinarse - to lean, to bend
asombro - astonishment
soltar - to release, to let go
callar - to be quiet, to silence
amplio/a - wide, spacious
recipiente - container
frasco - jar, bottle
corriente - current, flow
tocar - to touch, to play (an instrument)
pedírmelo - to ask me for it
prestar - to lend

